3,1,5,1,3,3,3,3,3,3,3
3,0,0,0,0,0,25,0,0,0,2
3,0,0,0,0,0,26,0,0,0,2
3,0,0,0,0,0,26,0,0,0,2
3,0,0,0,0,0,26,0,0,0,3
3,0,0,0,0,0,26,0,0,0,3
3,0,0,0,0,0,26,0,0,0,3
3,0,0,0,0,0,26,0,0,0,3
3,0,0,10,3,0,26,0,0,0,3
3,0,0,3,3,0,27,0,0,0,3
3,3,3,3,3,3,3,3,3,3,3
