3,3,2,2,2,3,3,3,3,3,3
3,0,0,0,0,0,0,0,0,0,3
3,0,0,0,0,0,0,0,0,0,3
3,0,0,0,0,0,0,0,0,0,3
3,0,0,0,0,0,0,0,0,0,3
3,18,19,19,20,3,3,3,3,3,3
3,0,0,0,0,0,10,0,0,0,3
3,0,0,0,0,0,8,0,0,0,3
3,0,0,0,0,0,0,0,0,0,3
3,0,0,0,0,0,0,0,0,0,3
3,3,3,3,3,1,4,1,3,3,3
