3,3,3,3,3,3,3,3,3,3,3
3,0,0,0,0,0,32,34,0,0,3
3,0,0,0,0,0,38,39,0,0,3
3,0,0,0,0,0,38,39,0,0,3
1,0,0,0,0,0,38,39,0,0,3
6,0,0,0,0,10,35,37,0,0,2
1,0,0,0,0,24,10,0,0,0,2
3,0,0,0,0,0,32,34,0,0,2
3,0,0,0,0,0,38,39,0,0,3
3,0,0,0,0,0,35,37,0,0,3
3,3,3,3,3,3,3,3,3,3,3
