3,2,2,2,3,3,3,3,3,3,3
3,0,0,0,21,0,8,0,0,0,3
3,0,0,0,23,0,0,0,0,0,3
3,3,3,3,3,0,3,3,0,3,3
3,0,0,0,0,0,0,3,0,10,3
3,0,0,0,0,0,0,3,0,0,3
3,0,0,0,0,0,0,3,0,0,3
3,0,0,3,3,3,3,3,0,0,3
3,3,0,0,0,0,0,0,0,10,3
3,3,3,0,0,0,0,0,0,0,3
3,3,3,3,1,4,1,3,3,3,3
